31 28
12 10
17 13.5
23 13.5
1	1	1	1	1	1	1	1	1	1	0	1	1	0	0	1	1	0	1	1	1	1	1	1	1	1	1	1
1	2	2	2	2	2	2	2	2	1	2	1	2	2	2	2	1	3	1	2	2	2	2	2	2	2	2	1
1	2	1	2	1	1	1	1	2	1	2	1	2	1	1	2	1	1	1	2	1	1	1	1	2	1	2	1
1	2	1	2	1	1	1	1	2	2	2	1	2	1	1	2	2	2	2	2	1	1	1	1	2	1	2	1
1	2	1	2	1	1	1	1	2	1	1	1	2	1	1	2	1	1	2	1	1	1	1	1	2	1	2	1
1	2	2	2	2	2	2	2	2	2	2	2	2	2	2	2	1	1	2	2	2	2	2	2	2	2	2	1
1	2	1	1	2	1	2	1	1	2	1	1	1	1	1	2	1	1	2	1	1	2	1	1	2	1	2	1
1	2	1	1	2	1	2	1	1	2	1	1	1	1	1	2	1	1	2	1	1	2	1	1	2	1	2	1
1	2	2	2	2	2	2	1	1	2	2	2	2	1	1	2	2	2	2	1	1	2	2	2	2	2	2	1
1	1	1	1	2	1	2	1	1	1	1	1	0	1	1	0	1	1	1	1	1	2	1	1	2	1	1	1
1	1	1	1	2	1	2	1	1	1	1	1	0	1	1	0	1	1	1	1	1	2	1	1	2	1	1	1
0	2	2	2	2	1	2	1	1	0	0	0	0	0	0	0	0	0	0	1	1	2	2	2	2	1	3	0
1	1	1	1	1	1	2	1	1	0	1	1	1	4	4	1	1	1	0	1	1	2	1	1	1	1	1	1
1	1	1	1	1	1	2	1	1	0	1	0	0	0	0	0	0	1	0	1	1	2	1	1	1	1	1	1
0	0	0	0	0	0	2	0	0	0	1	0	0	0	0	0	0	1	0	0	0	2	0	0	0	0	0	0
1	1	1	1	1	1	2	1	1	0	1	0	0	0	0	0	0	1	0	1	1	2	1	1	1	1	1	1
1	1	1	1	1	1	2	1	1	0	1	1	1	1	1	1	1	1	0	1	1	2	1	1	1	1	1	1
0	3	1	2	2	2	2	1	1	0	0	0	0	0	0	0	0	0	0	1	1	2	1	2	2	2	2	0
1	1	1	1	1	1	2	1	1	0	1	1	1	1	1	1	1	1	0	1	1	2	1	2	1	1	1	1
1	1	1	2	2	2	2	1	1	0	1	1	1	1	1	1	1	1	0	1	1	2	1	2	1	1	1	1
0	2	2	2	1	1	2	2	2	2	2	2	2	1	1	2	2	2	2	2	2	2	2	2	2	2	2	0
1	1	1	2	1	1	2	1	1	1	1	1	2	1	1	2	1	1	1	1	1	2	1	1	2	1	1	1
0	2	2	2	1	1	2	1	1	1	1	1	2	1	1	2	1	1	1	1	1	2	1	1	2	2	2	0
1	1	1	2	1	1	2	2	2	2	2	2	2	0	0	2	2	2	2	2	2	2	1	1	2	1	1	1
1	1	1	2	1	1	2	1	1	2	1	2	1	1	1	1	1	1	2	1	1	2	1	1	2	1	1	1
1	2	2	2	1	1	2	1	1	2	1	2	1	1	1	2	2	2	2	2	1	2	1	1	2	1	1	1
1	2	1	2	2	2	2	1	1	2	1	2	1	1	1	2	1	1	1	2	1	2	2	2	2	2	2	1
1	2	1	1	1	1	1	1	2	2	2	2	2	1	1	2	1	2	2	2	1	1	1	1	1	1	2	1
1	2	1	1	1	1	1	1	2	1	1	1	2	1	1	2	1	2	1	2	1	1	1	1	1	1	2	1
1	2	2	2	2	2	2	2	2	1	3	1	2	2	2	2	1	2	1	2	2	2	2	2	2	2	2	1
1	1	1	1	1	1	1	1	1	1	0	1	1	0	0	1	1	0	1	1	1	1	1	1	1	1	1	1
